"filename", "language", "TOML", "YAML", "Python", "comment", "blank", "total"
"/home/l1hy/Project/Python/CedTrainScheduler/.pre-commit-config.yaml", "YAML", 0, 13, 0, 0, 1, 14
"/home/l1hy/Project/Python/CedTrainScheduler/cedtrainscheduler/__init__.py", "Python", 0, 0, 0, 0, 1, 1
"/home/l1hy/Project/Python/CedTrainScheduler/cedtrainscheduler/scheduler/ced_scheduler.py", "Python", 0, 0, 167, 0, 34, 201
"/home/l1hy/Project/Python/CedTrainScheduler/cedtrainscheduler/scheduler/factory.py", "Python", 0, 0, 39, 0, 9, 48
"/home/l1hy/Project/Python/CedTrainScheduler/cedtrainscheduler/scheduler/fcfs_data_scheduler.py", "Python", 0, 0, 83, 0, 18, 101
"/home/l1hy/Project/Python/CedTrainScheduler/cedtrainscheduler/scheduler/fcfs_scheduler.py", "Python", 0, 0, 73, 0, 18, 91
"/home/l1hy/Project/Python/CedTrainScheduler/cedtrainscheduler/scheduler/scheduler.py", "Python", 0, 0, 51, 0, 10, 61
"/home/l1hy/Project/Python/CedTrainScheduler/cedtrainscheduler/scheduler/sjf_data_scheduler.py", "Python", 0, 0, 86, 0, 19, 105
"/home/l1hy/Project/Python/CedTrainScheduler/cedtrainscheduler/scheduler/sjf_scheduler.py", "Python", 0, 0, 76, 0, 18, 94
"/home/l1hy/Project/Python/CedTrainScheduler/cedtrainscheduler/scheduler/types/cluster.py", "Python", 0, 0, 43, 0, 16, 59
"/home/l1hy/Project/Python/CedTrainScheduler/cedtrainscheduler/scheduler/types/task.py", "Python", 0, 0, 46, 0, 15, 61
"/home/l1hy/Project/Python/CedTrainScheduler/cedtrainscheduler/simulator/config.py", "Python", 0, 0, 8, 0, 3, 11
"/home/l1hy/Project/Python/CedTrainScheduler/cedtrainscheduler/simulator/event.py", "Python", 0, 0, 43, 0, 19, 62
"/home/l1hy/Project/Python/CedTrainScheduler/cedtrainscheduler/simulator/executor.py", "Python", 0, 0, 36, 0, 9, 45
"/home/l1hy/Project/Python/CedTrainScheduler/cedtrainscheduler/simulator/fs.py", "Python", 0, 0, 108, 0, 34, 142
"/home/l1hy/Project/Python/CedTrainScheduler/cedtrainscheduler/simulator/manager.py", "Python", 0, 0, 75, 0, 15, 90
"/home/l1hy/Project/Python/CedTrainScheduler/cedtrainscheduler/simulator/record.py", "Python", 0, 0, 69, 0, 17, 86
"/home/l1hy/Project/Python/CedTrainScheduler/cedtrainscheduler/simulator/simulator.py", "Python", 0, 0, 161, 0, 17, 178
"/home/l1hy/Project/Python/CedTrainScheduler/cedtrainscheduler/simulator/types.py", "Python", 0, 0, 12, 0, 3, 15
"/home/l1hy/Project/Python/CedTrainScheduler/cedtrainscheduler/simulator/utils.py", "Python", 0, 0, 0, 0, 1, 1
"/home/l1hy/Project/Python/CedTrainScheduler/examples/simulator_example.py", "Python", 0, 0, 30, 0, 10, 40
"/home/l1hy/Project/Python/CedTrainScheduler/poetry.lock", "TOML", 826, 0, 0, 0, 46, 872
"/home/l1hy/Project/Python/CedTrainScheduler/pyproject.toml", "TOML", 36, 0, 0, 0, 8, 44
"Total", "-", 862, 13, 1206, 0, 341, 2422